EA texture_images/shirs.png
NO texture_images/mutul.png
WE texture_images/napol.png
SO texture_images/manet.png

F 220,100,0
C 225,30,0

111111111111111111
1N0000000000000001
1010111011101110101
1000000000000000001
1011101110111011101
1000000000000000001
111111111111111111
