EA texture_images/shirs.png
NO texture_images/mutul.png
WE texture_images/napol.png
SO texture_images/manet.png

F  100,100,100
C  200,200,200

111111111111111111111111111111
100000000000000011000000000001
101111111011111011011111111101
100000000010001000000000000001
101111111010101011111111111101
100000001010101000000000000001
101111101010101011111111111101
101000101000N01000000000000001
101011111011111111111111101111
100010001000100000000001000001
101110101011111011111101111101
100000101000001000100000000001
111111111111011111111111111111
100000000001010000000000000001
111101111101011111011111111101
100101000101010100010001000001
111101110111010101110101111101
100000000001000001000001000001
111111111111111111111111111111